{
	"size": [50, 23],
	"bgm": "",
	"bgs": "",
	"tileset": "Cave",
	"tiles": [
		[ 0,  0,  0,  0,  0,  0,  0,  0,  0,  0,  0,  0,  0,  0,  0,  0,  0,  0,  0,  0,  0,  0,  0,  0,  0,  0,  0,  0,  0,  0,  0,  0,  0,  0,  0,  0,  0,  0,  0,  0,  0,  0,  0,  0,  0,  0,  0,  0,  0,  0],
		[-1, -1,  0,  0,  0,  0,  0,  0,  0,  0,  0,  0, -1, -1,  0,  0,  0,  0,  0,  0,  0,  0,  0,  0,  0,  0,  0,  0,  0,  0,  0,  0,  0,  0,  0,  0,  0,  0,  0,  0,  0,  0,  0,  0,  0,  0,  0,  0,  0,  0],
		[-1, -1,  0,  0,  0,  0,  0,  0,  0,  0,  0,  0, -1, -1, -1, -1, -1, -1, -1, -1, -1, -1, -1, -1, -1, -1, -1, -1, -1, -1, -1, -1, -1,  0,  0,  0,  0,  0,  0,  0,  0,  0,  0,  0,  0,  0,  0,  0,  0,  0],
		[-1, -1,  0,  0,  0,  0,  0,  0,  0,  0,  0,  0, -1, -1, -1, -1, -1, -1, -1, -1, -1, -1, -1, -1, -1, -1, -1, -1, -1, -1, -1, -1, -1, -1, -1, -1, -1, -1, -1, -1, -1, -1, -1, -1, -1,  0,  0,  0,  0, -1],
		[-1, -1,  0,  0,  0,  0,  0,  0,  0,  0,  0,  0, -1, -1, -1, -1, -1, -1, -1, -1, -1, -1, -1, -1, -1, -1, -1, -1, -1, -1, -1, -1, -1, -1, -1, -1, -1, -1, -1, -1, -1, -1, -1, -1, -1,  0,  0,  0,  0, -1],
		[-1, -1,  0,  0,  0,  0,  0,  0,  0,  0,  0,  0, -1, -1, -1, -1, -1, -1, -1, -1, -1, -1, -1, -1, -1,  0,  0,  0,  0,  0,  0, -1, -1, -1, -1, -1, -1, -1, -1, -1, -1, -1, -1, -1, -1, -1,  0,  0, -1, -1],
		[ 0,  0,  0,  0,  0,  0,  0,  0,  0,  0,  0,  0, -1, -1, -1, -1, -1, -1, -1, -1, -1,  0,  0, -1, -1, -1, -1, -1, -1, -1, -1, -1, -1, -1, -1, -1, -1, -1, -1, -1, -1, -1, -1, -1, -1, -1, -1, -1, -1, -1],
		[ 0,  0,  0,  0,  0,  0,  0,  0,  0,  0,  0,  0,  0,  0,  0,  0, -1, -1, -1, -1, -1,  0,  0, -1, -1, -1, -1, -1, -1, -1, -1, -1, -1, -1, -1, -1, -1, -1, -1, -1, -1, -1, -1, -1, -1, -1, -1, -1, -1, -1],
		[ 0,  0,  0,  0,  0,  0,  0,  0,  0,  0,  0,  0,  0,  0,  0,  0,  0, -1, -1, -1, -1,  0,  0, -1, -1, -1, -1, -1, -1, -1, -1, -1, -1, -1, -1, -1, -1,  0,  0, -1, -1, -1, -1, -1, -1, -1, -1, -1, -1, -1],
		[ 0,  0,  0,  0,  0,  0,  0,  0,  0,  0,  0,  0,  0,  0,  0,  0,  0, -1, -1, -1, -1,  0,  0, -1, -1, -1, -1, -1, -1, -1, -1, -1, -1, -1, -1, -1,  0,  0,  0,  0, -1, -1, -1, -1, -1, -1, -1, -1, -1, -1],
		[ 0,  0,  0,  0,  0,  0,  0,  0,  0,  0,  0,  0, -1, -1, -1, -1, -1, -1, -1, -1, -1,  0,  0, -1, -1, -1, -1, -1, -1, -1, -1,  0,  0,  0,  0,  0,  0,  0,  0,  0,  0,  0,  0,  0,  0,  0,  0,  0,  0,  0],
		[ 0,  0,  0, -1, -1, -1, -1, -1, -1, -1, -1, -1, -1, -1, -1, -1, -1, -1, -1, -1, -1,  0,  0, -1, -1, -1, -1, -1, -1, -1, -1,  0,  0,  0,  0,  0,  0,  0,  0,  0,  0,  0,  0,  0,  0,  0,  0,  0,  0,  0],
		[ 0,  0,  0, -1, -1, -1, -1, -1, -1, -1, -1, -1, -1, -1, -1, -1, -1, -1, -1, -1, -1, -1, -1, -1, -1, -1, -1, -1, -1, -1, -1,  0,  0,  0,  0,  0,  0,  0,  0,  0,  0,  0,  0,  0,  0,  0,  0,  0,  0,  0],
		[ 0,  0,  0, -1, -1, -1, -1, -1, -1, -1, -1, -1, -1, -1, -1, -1, -1, -1, -1, -1, -1, -1, -1, -1, -1, -1, -1, -1, -1, -1, -1,  0,  0,  0,  0,  0,  0,  0,  0,  0,  0,  0,  0,  0,  0,  0,  0,  0,  0,  0],
		[ 0,  0,  0, -1, -1, -1, -1, -1, -1, -1, -1, -1, -1, -1, -1, -1, -1, -1, -1, -1, -1, -1, -1, -1, -1, -1, -1, -1, -1, -1, -1,  0,  0,  0,  0,  0,  0,  0,  0,  0,  0,  0,  0,  0,  0,  0,  0,  0,  0,  0],
		[ 0,  0,  0, -1, -1, -1, -1, -1, -1,  0,  0,  0,  0,  0, -1, -1, -1, -1, -1, -1, -1, -1, -1,  0,  0,  0,  0,  0, -1, -1, -1,  0,  0,  0,  0,  0,  0,  0,  0,  0,  0,  0,  0,  0,  0,  0,  0,  0,  0,  0],
		[ 0,  0,  0, -1, -1, -1, -1, -1, -1, -1, -1, -1, -1, -1, -1, -1, -1, -1, -1, -1, -1, -1, -1,  0,  0,  0,  0,  0, -1, -1, -1,  0,  0,  0,  0,  0,  0,  0,  0,  0,  0,  0,  0,  0,  0,  0,  0,  0,  0,  0],
		[ 0,  0,  0, -1, -1, -1, -1, -1, -1, -1, -1, -1, -1, -1, -1, -1, -1, -1, -1,  0,  0,  0,  0,  0,  0,  0,  0,  0, -1, -1, -1,  0,  0,  0,  0,  0,  0,  0,  0,  0,  0,  0,  0,  0,  0,  0,  0,  0,  0,  0],
		[ 0,  0,  0, -1, -1, -1, -1, -1, -1, -1, -1, -1, -1, -1, -1, -1, -1, -1, -1,  0,  0,  0,  0,  0,  0,  0,  0,  0, -1, -1, -1,  0,  0,  0,  0,  0,  0,  0,  0,  0,  0,  0,  0,  0,  0,  0,  0,  0,  0,  0],
		[ 0,  0,  0, -1, -1, -1,  0,  0,  0,  0,  0,  0,  0,  0,  0,  0,  0, -1, -1,  0,  0,  0,  0,  0,  0,  0,  0,  0, -1, -1, -1,  0,  0,  0,  0,  0,  0,  0,  0,  0,  0,  0,  0,  0,  0,  0,  0,  0,  0,  0],
		[ 0,  0,  0, -1, -1, -1,  0,  0,  0,  0,  0,  0,  0,  0,  0,  0,  0, -1, -1,  0,  0,  0,  0,  0,  0,  0,  0,  0, -1, -1, -1,  0,  0,  0,  0,  0,  0,  0,  0,  0,  0,  0,  0,  0,  0,  0,  0,  0,  0,  0],
		[ 0,  0,  0, -1, -1, -1,  0,  0,  0,  0,  0,  0,  0,  0,  0,  0,  0, -1, -1,  0,  0,  0,  0,  0,  0,  0,  0,  0, -1, -1, -1,  0,  0,  0,  0,  0,  0,  0,  0,  0,  0,  0,  0,  0,  0,  0,  0,  0,  0,  0],
		[ 0,  0,  0, -1, -1, -1,  0,  0,  0,  0,  0,  0,  0,  0,  0,  0,  0, -1, -1,  0,  0,  0,  0,  0,  0,  0,  0,  0, -1, -1, -1,  0,  0,  0,  0,  0,  0,  0,  0,  0,  0,  0,  0,  0,  0,  0,  0,  0,  0,  0]
	],
	"entities": [],
	"parallax": []
}