{
	"size": [21, 17],
	"bgm": "",
	"bgs": "",
	"tileset": "Outside",
	"tiles": [
		[-1, -1, -1, -1, -1, -1, -1, -1, -1, -1, -1, -1, -1, -1, -1, -1, -1,  3, -1, -1, -1],
		[-1, -1, -1, -1, -1, -1, -1, -1, -1, -1, -1, -1, -1, -1, -1, -1, -1,  3, -1, -1, -1],
		[-1, -1, -1, -1, -1, -1, -1, -1, -1, -1, -1, -1, -1, -1, -1, -1, -1,  3, -1, -1, -1],
		[-1, -1, -1, -1, -1, -1, -1, -1, -1, -1, -1, -1, -1, -1, -1, -1, -1,  3, -1, -1, -1],
		[-1, -1, -1, -1, -1, -1, -1, -1, -1, -1, -1, -1, -1,  3,  3, -1, -1,  3, -1, -1, -1],
		[-1, -1, -1, -1, -1, -1, -1, -1, -1, -1, -1, -1, -1, -1,  3, -1, -1,  3, -1, -1, -1],
		[-1, -1, -1, -1, -1, -1, -1, -1, -1, -1, -1, -1, -1, -1,  3, -1, -1,  3, -1, -1, -1],
		[-1, -1, -1, -1, -1,  3,  3,  3,  3, -1, -1, -1, -1, -1,  3, -1, -1,  3, -1, -1, -1],
		[-1, -1, -1, -1, -1, -1, -1, -1, -1, -1, -1, -1, -1, -1,  3, -1, -1,  3, -1, -1, -1],
		[ 3,  3,  3, -1, -1, -1, -1, -1, -1, -1, -1, -1, -1, -1,  3, -1, -1,  3, -1, -1, -1],
		[ 3,  3,  3, -1, -1, -1, -1, -1, -1, -1, -1, -1, -1, -1,  3, -1, -1,  3, -1, -1, -1],
		[ 3,  3,  3, -1, -1, -1, -1, -1, -1, -1, -1, -1, -1, -1,  3, -1, -1,  3, -1, -1, -1],
		[ 3,  3,  3, -1,  3,  3, -1, -1,  3,  3,  3, -1, -1, -1, -1, -1, -1,  3, -1, -1, -1],
		[ 3,  3,  3, -1, -1, -1, -1, -1, -1, -1, -1, -1, -1, -1, -1, -1, -1,  3, -1, -1, -1],
		[ 3,  3,  3, -1, -1, -1, -1, -1, -1, -1, -1, -1, -1, -1, -1, -1, -1,  3, -1, -1, -1],
		[ 3,  3,  3, -1, -1, -1, -1, -1, -1, -1, -1, -1,  3,  3,  3,  3,  3,  3, -1, -1, -1],
		[ 3,  3,  3, -1, -1, -1, -1, -1, -1, -1, -1, -1,  3,  3,  3,  3,  3,  3, -1, -1, -1]
	],
	"entities": []
}