{
	"size": [21, 17],
	"bgm": "",
	"bgs": "",
	"tileset": "Cave",
	"tiles": [
		[ 0,  0,  0,  0,  0,  0,  0,  0,  0,  0,  0,  0,  0,  0,  0,  0,  0,  0,  0,  0,  0],
		[ 0,  0,  0,  0,  0,  0,  0,  0,  0,  0,  0,  0,  0,  0,  0,  0,  0,  0,  0,  0,  0],
		[ 0,  0,  0,  0,  0,  0,  0,  0,  0,  0,  0,  0,  0,  0,  0,  0,  0,  0,  0,  0,  0],
		[ 0,  0,  0,  0,  0,  0,  0,  0,  0,  0,  0, -1,  0,  0,  0, -1, -1, -1,  0,  0,  0],
		[ 0,  0,  0,  0,  0,  0,  0, -1, -1, -1, -1, -1, -1, -1, -1,  0, -1, -1,  0,  0,  0],
		[ 0,  0,  0, -1,  0, -1, -1, -1, -1, -1, -1, -1, -1, -1, -1,  0,  0, -1,  0,  0,  0],
		[ 0,  0, -1,  0,  0, -1,  0,  0,  0,  0,  0,  0, -1, -1, -1, -1,  0, -1,  0,  0,  0],
		[ 0,  0,  0,  0, -1,  0,  0, -1, -1, -1, -1,  0, -1, -1, -1, -1,  0, -1,  0,  0,  0],
		[ 0,  0,  0, -1,  0, -1, -1, -1, -1, -1, -1,  0, -1, -1, -1, -1,  0, -1,  0,  0,  0],
		[ 0,  0,  0,  0,  0, -1, -1, -1, -1, -1, -1,  0, -1, -1, -1, -1,  0, -1,  0,  0,  0],
		[ 0,  0,  0,  0, -1, -1,  0,  0, -1, -1, -1,  0, -1, -1, -1,  0,  0, -1,  0,  0,  0],
		[ 0,  0,  0,  0, -1,  0,  0, -1,  0, -1,  0, -1, -1, -1, -1,  0, -1, -1,  0,  0,  0],
		[ 0,  0,  0,  0,  0,  0, -1, -1,  0,  0,  0, -1, -1,  0,  0, -1, -1, -1,  0,  0,  0],
		[ 0,  0,  0,  0,  0, -1, -1, -1,  0, -1, -1, -1,  0,  0, -1, -1, -1, -1,  0,  0,  0],
		[ 0,  0,  0,  0,  0,  0,  0,  0,  0, -1,  0,  0,  0, -1, -1, -1, -1, -1,  0,  0,  0],
		[ 0,  0,  0,  0,  0,  0,  0,  0,  0,  0,  0,  0,  0,  0,  0,  0,  0,  0,  0,  0,  0],
		[ 0,  0,  0,  0,  0,  0,  0,  0,  0,  0,  0,  0,  0,  0,  0,  0,  0,  0,  0,  0,  0]
	],
	"parallax": []
}