{
	"size": [40, 23],
	"bgm": "",
	"bgs": "",
	"tileset": "Outside",
	"tiles": [
		[ 3,  3,  3,  3,  3,  3,  3,  3,  3,  3,  3,  3,  3,  3,  3,  3,  3, -1, -1, -1, -1, -1, -1, -1, -1, -1, -1, -1, -1, -1, -1, -1, -1, -1, -1, -1,  1,  1,  1,  1],
		[ 3,  3,  3,  3,  3,  3,  3,  3, 29, 29,  3,  3,  3,  3,  3,  3,  3, -1, -1, -1, -1, -1, -1, -1, -1, -1, -1, -1, -1, -1, -1, -1, -1, -1, -1, -1, -1,  1,  1,  1],
		[ 3,  3,  3,  3,  3,  3,  3, 29, 29, 29, 29,  3,  3,  3,  3,  3,  3, -1, -1, -1, -1, -1, -1, -1, -1, -1, -1, -1, -1, -1, -1, -1, -1, -1, -1, -1, -1,  1,  1,  1],
		[ 3,  3,  3,  3,  3,  3,  3, 29, -1, -1, 29,  4, -1, -1, -1, -1,  4, -1, -1, -1, -1, -1, -1, -1, -1, -1, -1,  1, 27, 27, 27,  1,  1, -1, -1, -1, -1,  1,  1,  1],
		[29, 29, 29, 29, 29, 29, 30, 29, -1, -1, 29,  4, -1, -1, -1, -1,  4, -1, -1, -1, -1, -1, -1, -1, -1, -1, -1,  1, 27, 27, 27,  1,  1, -1, -1, -1, -1,  1,  1,  1],
		[29, -1, -1, -1, -1, -1, 30, -1, -1, -1, 29,  1,  1,  1,  1,  1,  1, -1, -1, -1, -1, -1, -1, -1, -1, -1, -1,  1, 27, 27,  1,  1,  1, -1, -1, -1, -1,  1,  1,  1],
		[29, -1, -1, -1, -1, -1, 30, -1, -1, -1, 29,  1,  1,  1,  1,  1,  1,  1, -1, -1, -1, -1, -1, -1, -1, -1, -1,  1, 27, 27, 27,  1,  1,  1,  1, 14,  1,  1,  1,  1],
		[29, -1, -1, -1, -1,  3,  3,  3, -1, -1, 29,  1,  1,  1,  1,  1,  1,  1,  1,  1, -1, -1, -1, -1, -1, -1, -1,  1, 27, 27, 27,  1,  1,  1,  1, 14,  1,  1,  1,  1],
		[29, -1, -1, -1, -1, -1, -1, -1, -1, -1, 29,  1,  1,  1,  1,  1,  1,  1,  1,  1, -1, -1, -1, -1, -1, -1, -1,  1,  1, 27, 27,  1,  1,  1, 27, 27, 27,  1,  1,  1],
		[12, 12, -1, -1, -1, -1, -1, -1, -1, -1, 29,  1,  1,  1,  1,  1,  1,  1,  1,  1, -1, -1, -1, -1, -1, -1, -1, 14, 27, 27, 27,  1,  1,  1, 27, 27, 27,  1,  1,  1],
		[12, 12, 12, 29, -1, -1, -1, -1, -1, -1, 29, 29, 29,  1,  1,  1,  1,  1,  1,  1, -1, -1, -1, -1, -1, -1, -1, 14, 27, 27, 27,  1,  1,  1, 27, 27, 27,  1,  1,  1],
		[12, 12, 12, 12, 29, -1, -1, -1, -1, -1, 29, 29, 29, 29,  1,  1,  1,  1,  1,  1,  1,  1,  1,  1,  1,  1,  1,  1,  1,  1,  1,  1,  1, 27, 27, 27, 27,  1,  1,  1],
		[ 3,  3,  3,  3,  3, 29, 29, 29, 29, 29,  1, 29, 29, 29, 29,  1,  1,  1,  1,  1,  1,  1,  1,  1,  1,  1,  1,  1,  1,  1,  1,  1, 27, 27, 27, 27, 27,  1,  1, -1],
		[ 3, 29, 29, 29,  3,  3, 29, 29, 29, 29,  1,  1, 29, 29, 29,  1,  1,  1,  1,  1,  1,  1,  1,  1,  1,  1,  1,  1,  1,  1,  1,  1, 27, 27, 27,  1,  1,  1,  1, -1],
		[ 3, 29, 29, 29, 29,  3, 29, 29, 29, 29,  1,  1,  1,  1,  1,  1,  1,  1,  1,  1,  1,  1,  1,  1,  1,  1,  1,  1,  1,  1,  1, 27, 27, 27, 27,  1,  1,  1,  1, -1],
		[ 6, 29, 29, 29, 29, 29, 29, 29, 29, 12,  1,  1,  1,  1,  1,  1,  1,  1,  1,  1,  1,  1,  1,  1,  1,  1,  1,  1,  1,  1, 27, 27, 27, 27,  1,  1,  1,  1,  1, -1],
		[ 6, 29, 29, 29, 29, 29, 29, 29, 12, 12,  1,  1,  1,  1,  1,  1,  1,  1,  1,  1,  1,  1,  1,  1,  1,  1,  1,  1,  1,  1, 27, 27, 27, 27, 27, 27, 27, 27,  6, -1],
		[ 1,  1,  1,  1,  1,  1, 15, 15, 15, 15,  1,  1,  1,  1,  1,  1,  1,  1,  1,  1,  1,  1,  1,  1,  1,  1,  1,  1,  1,  1, 27, 27, 27, 27, 27, 27, 27, 27,  6, -1],
		[ 1,  1,  1,  1,  1,  1,  1,  1,  1,  1,  1,  1,  1,  1,  1,  1,  1,  1,  1,  1,  1,  1,  1,  1,  1,  1,  1,  1,  1,  1, 27, 27, 27, 27, 27, 27,  1,  1,  1,  1],
		[ 1,  1,  1,  1,  1,  1,  1,  1,  1,  1,  1,  1,  1,  1,  1,  1,  1,  1,  1,  1,  1,  1,  1,  1,  1,  1,  1,  1,  1,  1,  1,  1, 27, 27, 27,  1,  1,  1,  1,  1],
		[ 1,  1,  1,  1,  1,  1,  1,  1,  1,  1,  1,  1,  1,  1,  1,  1,  1,  1,  1,  1,  1,  1,  1,  1,  1,  1,  1,  1,  1,  1,  1,  1,  1,  1,  1,  1,  1,  1,  1,  1],
		[ 1,  1,  1,  1,  1,  1,  1,  1,  1,  1,  1,  1,  1,  1,  1,  1,  1,  1,  1,  1,  1,  1,  1,  1,  1,  1,  1,  1,  1,  1,  1,  1,  1,  1,  1,  1,  1,  1,  1,  1],
		[ 1,  1,  1,  1,  1,  1,  1,  1,  1,  1,  1,  1,  1,  1,  1,  1,  1,  1,  1,  1,  1,  1,  1,  1,  1,  1,  1,  1,  1,  1,  1,  1,  1,  1,  1,  1,  1,  1,  1,  1]
	],
	"parallax": []
}